                           ██████                           
                         ██████████                         
                         ██████████                         
                         ██████████                         
                         ██████████                         
                         ██████████                         
                         ██████████                         
                      ████████████████                      
                   ██████████████████████                   
                   ██████████████████████                   
                   ██████████████████████                   
                    ████████████████████                    
                 ██████████████████████████                 
                ████████████████████████████                
                ████████████████████████████                
                 ██████████████████████████                 
                    ████████████████████                    
                   ██████████████████████                   
                   ██████████████████████                   
                   ██████████████████████                   
                   ██████████████████████                   
                    ████████████████████                    
                     █ █ ██████████ █ █                     
                         ██████████                         
                          █ █  █ █                          